SITE,PERIOD,Gazella,Cervidae,Capra,Bos,Sus,Total,%Gazella
Yiftah'el,MPPNB,1974,19,182,304,383,2862,69
Kfar ha Horesh,MPPNB,568,5,166,77,50,866,65.6
Motza,MPPNB,289,1,96,18,60,464,62.3
Motza,EPPNB,2881,5,201,100,358,3545,81.3
Hatoula,PPNA,1785,21,23,31,13,1873,95.3
Hatoula,LNAT,4512,113,45,76,67,4813,93.7
Hayonim Terrace,LNAT,5008,148,35,93,85,5369,93.3
Hayonim Cave,LNAT,883,71,8,4,43,1009,87.5
el-Wad Terrace,LNAT,300,4,0,7,6,317,94.6
el-Wad Terrace ,ENAT,1068,26,0,5,42,1141,93.6
Hayonim Cave,ENAT,1496,116,17,11,50,1690,88.5
Hefzibah,GKEB,6169,1685,0,212,11,8077,76.4
Neve David,GKEB,1540,814,0,13,9,2376,64.8
Nahal Hadera V,KEB,12528,5431,0,43,10,18012,69.6
Hayonim Cave,KEB,1039,379,36,53,63,1570,66.2
Meged Rockshelter,KEB,453,83,19,1,7,563,80.5
Meged Rockshelter,UP,160,27,7,5,4,203,78.8
Hayonim Cave,UP,6253,1162,103,77,52,7647,81.8
Hayonim Cave,MP1/2,101,53,1,17,5,177,57.1
Hayonim Cave,MP3,244,231,4,29,20,528,46.2
Hayonim Cave,MP4,792,1015,1,127,84,2019,39.2
Hayonim Cave,MP5/6,746,344,1,105,67,1263,59.1